r:15,c:20
#                  #
#                  #
#                  #
#           ww~w   #
#           ####   #
#                  #
#    #######       #
#                  #
#                  #
#                  #
#                  #
#          ~       #
##       ~~#~~~    #
####~~~########wwww#
####################
