r:15,c:20,s:64,g:1.6
#                 ##
#                  #
#                  #
#           ww~w   #
#           ####   #
#                  #
#    #######       #
#                  #
#                  #
#                  #
#                  #
#          ~      ##
##       ~~#~~~   ##
####~~~########wwww#
####################
